111111111111111111111111
1E0000000000000000000001
1000000000000CCCCC0C1P11
111111111111111111111111