1111111111111
10NP0000001C1
1000011110001
1000001E00001
1111111111111