11111111111111111111
1P00000C0000N000C001
10011011101110111001
1000100C100010C010C1
1000101110111C001001
100C1C00100C100C1001
1N00101110111C0010C1
1C00000N000C000N00E1
11111111111111111111