
1111111111111111111111111111111111111111111111111111111111111111111111111111111111111111111111111111111111111111111111111111111111111111111111111111111111111111111111111111111111111111111111111111111111111111111111111111111111111
1000111100001111000001111000001111000001111000001111000001111000001111000001111000001111000001111000001111000001111000001111000001111000001111000001111000001111000001111000001111000001111000001111000001111000001111000001111000001
1011110000011110000011110000011110000111100000111100000111100000111100000111100000111100000111100000111100000111100000111100000111100000111100000111100000111100000111100000111100000111100000111100000111100000111100000111100000011
1011110000011110000011110000011110P00011110000011110000011110000011110000011110000011110000011110000011110000011110000011110000011110000011110000011110000011110000011110000011110000011110000011110000011110000011110000011110000011
101111000001111000001111000001111C000E11110000011110000011110000011110000011110000011110000011110000011110000011110000011110000011110000011110000011110000011110000011110000011110000011110000011110000011110000011110000011110000011
10111100000111100000111100000111100N0011110000011110000011110000011110000011110000000000000011110000011110000011110000011110000011110000011110000011110000011110000011110000011110000011110000011110000011110000011110000011110000011
1011110000011110000011110000011110000011110000011110000011110000011110000011110000000000000011110000011110000011110000011110000011110000011110000011110000011110000011110000011110000011110000011110000011110000011110000011110000011
1011110000011110000011110000011110C00011110000011110000011110000011110000011110000000000000011110000011110000011110000011110000011110000011110000011110000011110000011110000011110000011110000011110000011110000011110000011110000011
1011110000011110000011110000011110000011110000011110000011110000011110000011110000000000000011110000011110000011110000011110000011110000011110000011110000011110000011110000011110000011110000011110000011110000011110000011110000011
1011110000011110000011110000011110000011110000011110000011110000011110000011110000000000000011110000011110000011110000011110000011110000011110000011110000011110000011110000011110000011110000011110000011110000011110000011110000011
1011110000011110000011110000011110000011110000011110000011110000011110000011110000000000000011110000011110000011110000011110000011110000011110000011110000011110000011110000011110000011110000011110000011110000011110000011110000011
1011110000011110000011110000011110000011110000011110000011110000011110000011110000000000000011110000011110000011110000011110000011110000011110000011110000011110000011110000011110000011110000011110000011110000011110000011110000011
1011110000011110000011110000011110000011110000011110000011110000011110000011110000000000000011110000011110000011110000011110000011110000011110000011110000011110000011110000011110000011110000011110000011110000011110000011110000011
1011110000011110000011110000011110000011110000011110000011110000011110000011110000000000000011110000011110000011110000011110000011110000011110000011110000011110000011110000011110000011110000011110000011110000011110000011110000011
1011110000011110000011110000011110000011110000011110000011110000011110000011110000000000000011110000011110000011110000011110000011110000011110000011110000011110000011110000011110000011110000011110000011110000011110000011110000011
1011110000011110000011110000011110000011110000011110000011110000011110000011110000000000000011110000011110000011110000011110000011110000011110000011110000011110000011110000011110000011110000011110000011110000011110000011110000011
1011110000011110000011110000011110000011110000011110000011110000011110000011110000011110000011110000011110000011110000011110000011110000011110000011110000011110000011110000011110000011110000011110000011110000011110000011110000011
1011110000011110000011110000011110000011110000011110000011110000011110000011110000011110000011110000011110000011110000011110000011110000011110000011110000011110000011110000011110000011110000011110000011110000011110000011110000011
1011110000011110000011110000011110000011110000011110000011110000011110000011110000011110000011110000011110000011110000011110000011110000011110000111100000111100000111100000111100000111100000111100000111100000111000001111000001111
1011110000011110000011110000011110000011110000011110000011110000011110000011110000011110000011110000011110000011110000011110000011110000011110000011110000011110000011110000011110000011110000011110000011110000011110000011110000011
1011110000011110000011110000011110000011110000011110000011110000011110000011110000011110000011110000011110000011110000011110000011110000011110000011110000011110000011110000011110000011110000011110000011110000011110000011110000011
1111111111111111111111111111111111111111111111111111111111111111111111111111111111111111111111111111111111111111111111111111111111111111111111111111111111111111111111111111111111111111111111111111111111111111111111111111111111111