111111111111111111111111
1E000000000000N000000001
1000000000000CCCCC0C1P11
111111111111111111111111