111111111111111111111111
1E0000000000000000000001

1P00000000000CCCCC0C0001
111111111111111111111111
