11111111111111111111
1P00000C00000000C001
10011011101110111001
1000100C100010C010C1
100N101110111C001001
100C1C00100C100C1001
1000101110111C0010C1
1C000000000C000000E1
11111111111111111111
