1111111111111
10010000001C1
1000011110001

10P0011E00001
1111111111111